#######
#a.#Cd#
##@#@##
#######
##@#@##
#cB#.b#
#######