########################
#.......a..............#
#######.#######.######.#
#........@.............#
########################