#################################################################################
#.............#...#...O.#.#...........#.#...#.........#.......#.....#.......#.Z.#
#####.#######.#H#.#.###.#.#.#####.###.#.#.###.#####.#.#.#####.#.###.#.###.###.#.#
#.....#.#...#.#.#...#.#.#.#.#.#...#.....#.#...#...#.#.#...#w..#...#...#.#.....#.#
#.#####.#.#.#.#.#####.#.#.#B#.#.#########.#.###.#.#.#####.#.#####.#####.#######.#
#.#...#...#.....#...#.#.#.....#.........#.#.#...#.#.....#.#...#..y..#...#.....#.#
#.#.#.#.#########.#.#.#.###########.###.#.#.#.#######.###.###.#####.#.#.#.###.#.#
#.#.#...#.........#.#.......#.....#...#.#.#.#.#.....#.....#.#.#...#...#.#.#...#.#
#.###.###.#########.#######.#.###.#####.#.#.#.#.###.#######.#.#.#.#####.#.#.###.#
#...#.#.....#x....#.#..f..#...#...#...#.#.#.#.....#.....#i..#...#.#...#.#.#.#...#
#.#.#.#.#####.###.#.#A###.#####.###.#.#.#.#.#########.#.#.#.#####.#.#.###.#.#.#.#
#.#.#.#.#...#.#.#.#...#.#.#...#.#.T.#...#.#...#.....#.#...#.#.#..e#.#.....#.#.#.#
###.###.#X#.#.#.#.#.###.#.###.#.###.###.#.###.#.###.#.#####.#.#.###.#######.#.#.#
#...#d..#.#...#.#.#.....#...#.#...#...#.#...#.#.#.....#.......#.#.....#.#...#.#.#
#.###.###.#####R#.#####.###.#.###.###.#.#.#.#.#.###########.###.#.###.#.#.#####.#
#...#.#.#...#.......#...#...#...#.....#.#.#...#.....#.....#.#...#...#.#...#...#.#
###E#.#.###.#######.#####.###.#.#######.#.#####.###N#.###.###.###.###.#.###.#.#.#
#.#...#...#..c..#...#r..F.#...#.....#.#.#...#.#.#.#.#...#.#...#...#...#.....#.#.#
#.#####.#######.###.#.#######.#####.#.#.###.#.#.#.#.###.#.#.###.###.#########.#.#
#z....#.......#...#...#.....#s#.......#.#.#.#.....#...#.#...#v..#.#...#.....#...#
#.#.###.#.#######.#####G###.#.#######.#.#.#.#####.#.###.#######.#.###.#.#######.#
#.#.#...#.......#...#...#.#.#...#...#.#.#.#.....#.#...#.D.....#.....#.#.......#.#
###.#.#########.###C#####.#.#.#.#.#.###.#.#####.#####.###############.#.#####.#.#
#...#...#.....#...#....g....#.#.#.#.....#.....#.....#...........#.....#.....#...#
#.#####.#.###.#.#############.#.#.#######.#########.#.#######.#.#.#########.#####
#.....#...#...#.#.........#...#.#.#.....#.........#.#.#.....#.#...#.......#.#..u#
#Q#.#######.###.#.#.#.#####.###.#.#####.#.#######.#.###.###.#.#####.###.#.#.#.###
#.#.......#.#...#.#.#.#...#.#.#...#...#.#.#.....#.#.#...#.#.#...#.....#.#.#.#...#
#.#####.###.#.###.#.###.#.#.#.#####.#.#.#.#.###.#.#.#.###.#.#.#.#######.#.#.#.#.#
#...#...#...#.....#.....#...#.......#...#.#.#.#.K.#...#.#...#.#.#.......#.#.#.#.#
###.#.###.#####################.###.#####.#.#.#.#######.#.#####.#.#####.###.#.#.#
#...#.....#...#.....#.........#...#.#...#.#.#...#.......#...#...#...#...#...#.#.#
#.#########.###.###.#.###.###.###.#.#.#.###.#####.#.###.###.#.###.#.#.###.#####.#
#.#.....#.........#...#...#.#.#.#.#.#.#.#...#.....#.#l..#.#.#...#.#.#...#...#...#
#.###.#.###.###########.###.#.#.#.#.#.#.#.###.#####.#.###.#.###.#.#.#.#####.#.#.#
#.#...#...#...#...#.....#...#.#...#...#.#...#.#.#...#.....#.....#.#.#.#...#.#.#.#
#.#.#####.#.###.#.#.#####.###.#########.#.#.#.#.#.#################.###.#.#P#.#.#
#.#.#.....#.#...#.#...#.#...#.#.....#...#.#.#.#.#.#.................#...#...#.#.#
#.#.#.#######.###.###.#.#.#.#.#.###.#.#.#.#.#.#.#.#.#########.#######.#######.#.#
#.U.#p........#....j..#...#.....#.....#@#@#.....#...........#...........J.....#.#
#################################################################################
#...#.....#...#.......#.........#......@#@#.....#.....#.....#.....#.............#
#.#.#.###.###.#.#L###.#.#####.###.#.###.#.#.#.###.#.###.#.#.#.#.#.#.#########.#.#
#.#...#.....#...#...#.#.#...#.....#...#.#...#.....#.....#.#.#.#.#.#.#.......#q#.#
#.#.#######.#.#####.#.###.#.#########.#.#.###############.###.#.#.###.#####.###.#
#.#.#.....#.#...#...#.....#.#.........#.#.#.....#.....#...#...#.#.....#...#...#.#
#.#.#.###.#.#####.#########.#.#########.#.#.#.#.#.###.#.###.###.#.#####.#.###.#.#
#.#.#...#.#.....#.....#...#...#.......#.#.#.#.#...#...#.#.....#.#.#...#.#...#...#
#.#####.#.#####.#####.#.#######.###.###.#.#.#.#####.###.#.#####.#.#.#.#.###.###.#
#.....#.#...#...#...#.#...........#...#.#k#.#...#.....#.#.#.....#.#.#.#...#...#.#
#####.#.###.###.#.#.#.#.#############.#.#.#.###.#.#####.#.#.#######.#.###.#.###.#
#.....#...#...#...#...#.#...........#...#.#...#.#...#...#.#...#...#.#...#.#.....#
#.#######.###.#####.#####.#########.#.###.#####.###.#.###.###.#.#.#.###.#.#######
#.......#...#.....#.#.....#.......#.#...#.......#.#.#.#...#.#...#.....#.#.#.....#
#.###.#####.#####.###.#####.#.#.###.#############.#.#.#.###.###########.#.#.###.#
#...#.#.........#...#.#.....#.#.#...#...#...#.....#.#...#...#.......#...#.#.#m..#
#.###.#.###########.#.#######.###.###.#.#.#.#.#.###.#####.#.#######.#.###.#.#.#.#
#.#...#...#.#.......#...#...#.W...#...#.#.#.#.#.....#.....#...#.....#...#.#.#.#.#
###.#.###.#.#.#########.#.#.#####.###.#.#.###.#######.#######.#.###.###.#.###.#.#
#...#...#...#...#.....#...#.....#...#.#.#.#...#.........#.......#.#.#...#.....#.#
#.#########.###.#.#.###########.###.#.#.#.#.###.#######.#.#######.#.#.#########.#
#.........#.#...#.#.#....a......#.#...#.#.#...#.#.......#.#...#.....#.#...#.....#
#.#######.#.#.###.#.#############.#####.#.###.#.#.#######.#.###.#####.###.#.#####
#.#.....#...#.#...#.....#...#.......#h..#.....#.#.#.......#.#...#...#...#.#.#...#
#.###.#.#####.#.#####.#.#.#.#.#####.#.###.#######.#######.#.#####.#.###.#.#.#.#.#
#...#.#...#...#.#...#.#.#.#..o#...#...#.#.......#.......#.#.....#.#.#...#.....#.#
###.#####.#.#.#.###.#.###.#######.#####.#######.#.#####.#######.#.#.#.###########
#.#...#...#.#.#.....#.....#.#.......#...#...#...#.....#.......#.#.#.#...#.......#
#.###.#.###.#.#####.#######.#.#I###.###.#.#.#.###########.###.#.#.#.###.#.#####.#
#...#...#...#.....#.#.#.....#.#...#t..#.#.#...#.........#.#.#.#...#...#...#.....#
#.#####.#.#########.#.#.###.#.###.###.#.#.#####.#######.#.#.#.#######.#####.#####
#...M...#.......#...#...#.#...#.#...#...#.......#.....#.#.#.........#.....#.#...#
#.#############.#.###.###.#####.###.#############.#####.#.#.#######.#####.#.###.#
#.#.....Y...#.#.#.#.#.#..b..#...#.#.#...#...#.........#.#.#.#...#.#.#...#...#...#
#.#.#######.#.#.#.#.#.###.#.#.#.#.#.#.#.#.#.#.#######.#.#.###.#.#.#.#.#.#####.#.#
#...#n....#.#.#...#.......#...#...#...#.#.#.#.#.....#...#.....#.#...#.#.......#.#
#####.###.#.#.###################.#####.#.###.#.###.#####V#####.#.###.###.#####.#
#.....#...#...#.....#...#...#.....#.....#.....#...#...........#.#...#.#...#.....#
#.###########.###.#.#.#.#.#.#######.###.#.#####################.###.###.###.#####
#.................#...#...#.........#.S.#.......................#.......#.......#
#################################################################################